----------------------------------------------------------------------
*--****--**--****--**--****--**--****--**--****--**--****--**--****--*
*-**--**-**-**--**-**-**--**-**-**--**-**-**--**-**-**--**-**-**--**-*
---****------****------****------****------****------****------****---
-*-*--*-*--*-*--*-*--*-*--*-*--*-*--*-*--*-*--*-*--*-*--*-*--*-*--*-*-
-*-*--*-*--*-*--*-*--*-*--*-*--*-*--*-*--*-*--*-*--*-*--*-*--*-*--*-*-
---****------****------****------****------****------****------****---
*-**--**-**-**--**-**-**--**-**-**--**-**-**--**-**-**--**-**-**--**-*
*--****--**--****--**--****--**--****--**--****--**--****--**--****--*
----------------------------------------------------------------------
----------------------------------------------------------------------
*--****--**--****--**--****--**--****--**--****--**--****--**--****--*
*-**--**-**-**--**-**-**--**-**-**--**-**-**--**-**-**--**-**-**--**-*
---****------****------****------****------****------****------****---
-*-*--*-*--*-*--*-*--*-*--*-*--*-*--*-*--*-*--*-*--*-*--*-*--*-*--*-*-
-*-*--*-*--*-*--*-*--*-*--*-*--*-*--*-*--*-*--*-*--*-*--*-*--*-*--*-*-
---****------****------****------****------****------****------****---
*-**--**-**-**--**-**-**--**-**-**--**-**-**--**-**-**--**-**-**--**-*
*--****--**--****--**--****--**--****--**--****--**--****--**--****--*
----------------------------------------------------------------------
----------------------------------------------------------------------
*--****--**--****--**--****--**--****--**--****--**--****--**--****--*
*-**--**-**-**--**-**-**--**-**-**--**-**-**--**-**-**--**-**-**--**-*
---****------****------****------****------****------****------****---
-*-*--*-*--*-*--*-*--*-*--*-*--*-*--*-*--*-*--*-*--*-*--*-*--*-*--*-*-
-*-*--*-*--*-*--*-*--*-*--*-*--*-*--*-*--*-*--*-*--*-*--*-*--*-*--*-*-
---****------****------****------****------****------****------****---
*-**--**-**-**--**-**-**--**-**-**--**-**-**--**-**-**--**-**-**--**-*
*--****--**--****--**--****--**--****--**--****--**--****--**--****--*
----------------------------------------------------------------------
----------------------------------------------------------------------
*--****--**--****--**--****--**--****--**--****--**--****--**--****--*
*-**--**-**-**--**-**-**--**-**-**--**-**-**--**-**-**--**-**-**--**-*
---****------****------****------****------****------****------****---
-*-*--*-*--*-*--*-*--*-*--*-*--*-*--*-*--*-*--*-*--*-*--*-*--*-*--*-*-
-*-*--*-*--*-*--*-*--*-*--*-*--*-*--*-*--*-*--*-*--*-*--*-*--*-*--*-*-
---****------****------****------****------****------****------****---
*-**--**-**-**--**-**-**--**-**-**--**-**-**--**-**-**--**-**-**--**-*
*--****--**--****--**--****--**--****--**--****--**--****--**--****--*
----------------------------------------------------------------------
----------------------------------------------------------------------
*--****--**--****--**--****--**--****--**--****--**--****--**--****--*
*-**--**-**-**--**-**-**--**-**-**--**-**-**--**-**-**--**-**-**--**-*
---****------****------****------****------****------****------****---
-*-*--*-*--*-*--*-*--*-*--*-*--*-*--*-*--*-*--*-*--*-*--*-*--*-*--*-*-
-*-*--*-*--*-*--*-*--*-*--*-*--*-*--*-*--*-*--*-*--*-*--*-*--*-*--*-*-
---****------****------****------****------****------****------****---
*-**--**-**-**--**-**-**--**-**-**--**-**-**--**-**-**--**-**-**--**-*
*--****--**--****--**--****--**--****--**--****--**--****--**--****--*
----------------------------------------------------------------------