----------
*--****--*
*-**--**-*
---****---
-*-*--*-*-
-*-*--*-*-
---****---
*-**--**-*
*--****--*
----------