---------------------------------------------------------------------------
---------------------------------------------------------------------------
---------------------------------------------------------------------------
---------------------------------------------------------------------------
---------------------------------------------------------------------------
---------------------------------------------------------------------------
---------------------------------------------------------------------------
---------------------------------------------------------------------------
-------****-------*----*******-*******-*-------*******---------------------
-------**--*-----*-*------*-------*----*-------*---------------------------
-------**---*----*-*------*-------*----*-------*---------------------------
-------**---*----*-*------*-------*----*-------*---------------------------
-------**--*-----*-*------*-------*----*-------*****-----------------------
-------****-----*---*-----*-------*----*-------*---------------------------
-------**--**---*****-----*-------*----*-------*---------------------------
-------**----*--*---*-----*-------*----*-------*---------------------------
-------**----*-*-----*----*-------*----*-------*---------------------------
-------******--*-----*----*-------*----*******-*******---------------------
---------------------------------------------------------------------------
---------------------------------------------------------------------------
---------------------------------------------------------------------------
------------------***---**--*******--*-----*-------------------------------
-----------------*------**-----*-----**---**-------------------------------
----------------*--------------*------**--*--------------------------------
---------------*--------**-----*-------****--------------------------------
---------------*--------**-----*--------***--------------------------------
---------------*--------**-----*----------*--------------------------------
---------------*--------**-----*----------*--------------------------------
----------------*-------**-----*---------**--------------------------------
-----------------*------**-----*--------***--------------------------------
------------------***---**-----*-------***---------------------------------
---------------------------------------------------------------------------
---------------------------------------------------------------------------
---------------------------------------------------------------------------
---------------------------------------------------------------------------
---------------------------------------------------------------------------
---------------------------------------------------------------------------
---------------------------------------------------------------------------
---------------------------------------------------------------------------
---------------------------------------------------------------------------
---------------------------------------------------------------------------
---------------------------------------------------------------------------
---------------------------------------------------------------------------
---------------------------------------------------------------------------
---------------------------------------------------------------------------
---------------------------------------------------------------------------
---------------------------------------------------------------------------
---------------------------------------------------------------------------
---------------------------------------------------------------------------
---------------------------------------------------------------------------