--------------------------------%%%%****%%%%-------------------------------
---------------A----------------%%%%****%%%%-------------------------------
--------------------------------%%%%****%%%%-------------------------------
--------------------------------%%%%****%%%%-------------------------------
--------------------------B-----%%%%****%%%%-------------------------------
-----*******--------------------%%%%****%%%%-------------------*******-----
-----*******--------###---------%%%%****%%%%---------###-------*******-----
-----*******--------###---------%%%%****%%%%---------###-------*******-----
-----*******--------###---------%%%%****%%%%---------###-------*******-----
-----*******--------###---------%%%%****%%%%---------###-------*******-----
--###*******--------###---------%%%%****%%%%---------###-------*******###--
-----*******---C----###---------%%%%****%%%%---------###-------*******-----
-----*******--------###---------************---------###-------*******-----
-----*******--------############************############-------*******-----
-----*******--------############************############-------*******-----
-----*******--------------------************-------------------*******-----
-----*******--------------------************-------------------*******-----
-----*******-----------D---------------------------------------*******-----
---------------------------------------------------------------------------
--#---------------------------------------------------------------------#--
--#---------------------------------------------------------------------#--
--#------------*************--------------------*************-----------#--
--#------------*************--------------------*************-----------#--
--#------------*************------########------*************-----------#--
--#------------*************------########------*************-----------#--
--#------------*************------########------*************-----------#--
--#------------*************--------------------*************-----------#--
--#------------*************--------------------*************-----------#--
--#---------------------------------------------------------------------#--
--#---------------------------------------------------------------------#--
---------------------------------------------------------------------------
-----*******---------------------------------------------------*******-----
-----*******--------------------************-------------------*******-----
-----*******--------------------************-------------------*******-----
-----*******--------############************############-------*******-----
-----*******--------############************############-------*******-----
-----*******--------###---------************---------###-------*******-----
-----*******--------###---------%%%%****%%%%---------###-------*******-----
--###*******--------###---------%%%%****%%%%---------###-------*******###--
-----*******--------###---------%%%%****%%%%---------###-------*******-----
-----*******--------###---------%%%%****%%%%---------###-------*******-----
-----*******--------###---------%%%%****%%%%---------###-------*******-----
-----*******--------###---------%%%%****%%%%---------###-------*******-----
-----*******--------###---------%%%%****%%%%---------###-------*******-----
-----*******--------------------%%%%****%%%%-------------------*******-----
--------------------------------%%%%****%%%%-------------------------------
--------------------------------%%%%****%%%%-------------------------------
--------------------------------%%%%****%%%%-------------------------------
--------------------------------%%%%****%%%%-------------------------------
--------------------------------%%%%****%%%%-------------------------------